55124613
41543442
35316403
12631664
66113161
21600322
01356641
26560554
